1984 - George Orwell
A Christmas Carol - Charles Dickens
A Confederacy of Dunces - John Kennedy Toole
Adventures of Sherlock Holmes - Sir Arthur Conan Doyle
A Fine Balance - Rohinton Mistry
Alice in Wonderland - Lewis Carroll
Animal Farm - George Orwell
Anna Karenina - Leo Tolstoy
Anne of Green Gables - LM Montgomery
A Prayer for Owen Meaney - John Irving
A Suitable Boy - Vikram Seth
A Tale Of Two Cities - Charles Dickens
Atonement - Ian McEwan
A Town Like Alice - Nevil Shute
Birdsong - Sebastian Faulk
Bleak House - Charles Dickens
Brave New World - Aldous Huxley
Brideshead Revisited - Evelyn Waugh
Bridget Jones’s Diary - Helen Fielding
Captain Corelli’s Mandolin - Louis De Bernieres
Catch 22 - Joseph Heller
Catcher in the Rye - JD Salinger
Charlie and the Chocolate Factory - Roald Dahl
Charlotte’s Web - EB White
Cloud Atlas - David Mitchel
Cold Comfort Farm - Stella Gibbons
Count of Monte Cristo - Alexandre Dumas
Crime and Punishment - Fyodor Dostoyevsky
David Copperfield - Charles Dickens
Dracula - Bram Stoker
Dune - Frank Herbert
Emma - Jane Austen
Far From The Madding Crowd - Thomas Hardy
Germinal - Emile Zol
Gone With The Wind - Margaret Mitchell
Grapes of Wrath - John Steinbeck
Great Expectations - Charles Dickens
Hamlet - William Shakespeare
Harry Potter and the Sorcerer's Stone JK Rowling
Heart of Darkness - Joseph Conrad
Jane Eyre Charlotte Bronte
Jude the Obscure - Thomas Hardy
Les Miserables - Victor Hugo
Life of Pi - Yann Martel
Little Women - Louisa M Alcott
Lolita - Vladimir Nabokov
Lord of the Flies - William Golding
Love In The Time Of Cholera - Gabriel Garcia Marquez
Madame Bovary - Gustave Flaubert
Memoirs of a Geisha - Arthur Golden
Middlemarch - George Eliot
Midnight’s Children - Salman Rushdie
Moby Dick - Herman Melville
Northern Lights (The Golden Compass) - Philip Pullman
Notes From A Small Island - Bill Bryson
Of Mice and Men - John Steinbeck
Oliver Twist - Charles Dickens
One Hundred Years of Solitude - Gabriel Garcia Marquez
On The Road - Jack Kerouac
Persuasion - Jane Austen
Possession - AS Byatt
Pride and Prejudice - Jane Austen
Rebecca - Daphne Du Maurier
Romeo and Juliet - William Shakespeare
Sense and Sensibility - Jane Austen
Swallows and Amazons - Arthur Ransom
Tess of the D’Urbervilles - Thomas Hardy
The Adventures of Tom Sawyer - Mark Twain
The Color Purple - Alice Walker
The Curious Incident of the Dog in the Night-time - Mark Haddon
The Da Vinci Code - Dan Brown
The Faraway Tree Collection - Enid Blyton
The Five People You Meet In Heaven - Mitch Albom
The Great Gatsby - F Scott Fitzgerald
The Handmaid’s Tale - Margaret Atwood
The Hitch Hiker’s Guide to the Galaxy - Douglas Adams
The Hobbit - JRR Tolkien
The Inferno - Dante
The Kite Runner - Khaled Hosseini
The Lion, The Witch and the Wardrobe - CS Lewis
The Little Prince - Antoine De Saint-Exupery
The Lord of the Rings - JRR Tolkien
The Lovely Bones - Alice Sebold
The Remains of the Day - Kazuo Ishiguro
The Secret Garden - Frances Hodgson Burnett
The Secret History - Donna Tartt
The Shadow of the Wind - Carlos Ruiz Zafon
The Three Musketeers - Alexandre Dumas
The Time Traveler’s Wife - Audrey Niffenegger
The Wasp Factory - Iain Banks
The Wind in the Willows - Kenneth Grahame
The Woman in White - Wilkie Collins
To Kill a Mockingbird Harper Lee
Ulysses - James Joyce
Vanity Fair - William Makepeace Thackera
War and Peace - Leo Tolstoy
Watership Down - Richard Adams
Winnie the Pooh - AA Milne
Wuthering Heights - Emily Bronte
Water for Elephants - Sara Gruen
